//MAP CONVERTED BY dmm2tgm.py THIS HEADER COMMENT PREVENTS RECONVERSION, DO NOT REMOVE
"at" = (
/obj/machinery/power/terminal,
/obj/structure/cable,
/obj/machinery/atmospherics/pipe/manifold/supply/hidden,
/obj/effect/turf_decal/trimline/transparent/blue/warning{
	dir = 1
	},
/turf/open/floor/plating/airless,
/area/ship/bridge)
"cj" = (
/obj/machinery/power/smes/shuttle/precharged{
	dir = 1
	},
/obj/structure/window/reinforced/survival_pod/spawner,
/obj/machinery/door/window/survival_pod{
	dir = 1
	},
/obj/effect/turf_decal/industrial/warning,
/obj/effect/turf_decal/industrial/warning{
	dir = 1
	},
/obj/structure/cable{
	icon_state = "0-4"
	},
/obj/machinery/door/poddoor/preopen{
	id = "herman_maint"
	},
/turf/open/floor/plating,
/area/ship/bridge)
"cZ" = (
/obj/machinery/power/shuttle/engine/electric/premium{
	dir = 8
	},
/obj/structure/window/reinforced/survival_pod/spawner,
/obj/structure/window/reinforced/survival_pod/spawner/west,
/obj/effect/turf_decal/industrial/warning/cee{
	dir = 4
	},
/obj/structure/window/reinforced/survival_pod/spawner/north,
/obj/structure/cable{
	icon_state = "0-8"
	},
/turf/open/floor/plating,
/area/ship/bridge)
"dd" = (
/obj/structure/cable{
	icon_state = "2-8"
	},
/obj/structure/closet/crate/engineering,
/obj/item/storage/toolbox/mechanical,
/obj/item/stack/sheet/mineral/plasma/twenty,
/obj/effect/turf_decal/box/white,
/obj/structure/extinguisher_cabinet/directional/north,
/obj/effect/turf_decal/trimline/transparent/blue/warning,
/turf/open/floor/plasteel/mono/dark,
/area/ship/bridge)
"dp" = (
/obj/effect/turf_decal/trimline/transparent/blue/warning{
	dir = 8
	},
/obj/effect/turf_decal/industrial/warning{
	dir = 4
	},
/obj/machinery/door/poddoor/preopen{
	id = "herman_maint";
	dir = 4
	},
/obj/machinery/door/firedoor/border_only{
	dir = 8
	},
/obj/machinery/door/firedoor/border_only{
	dir = 4
	},
/turf/open/floor/plating/airless,
/area/ship/bridge)
"eu" = (
/obj/machinery/atmospherics/components/binary/valve/on{
	dir = 8
	},
/obj/effect/turf_decal/trimline/transparent/blue/corner{
	dir = 8
	},
/obj/effect/turf_decal/industrial/warning{
	dir = 4
	},
/obj/machinery/door/poddoor/preopen{
	id = "herman_maint";
	dir = 4
	},
/obj/machinery/door/firedoor/border_only{
	dir = 8
	},
/obj/machinery/door/firedoor/border_only{
	dir = 4
	},
/turf/open/floor/plating/airless,
/area/ship/bridge)
"fr" = (
/obj/structure/sign/number/random,
/turf/closed/wall/mineral/plastitanium/nodiagonal,
/area/ship/bridge)
"iy" = (
/turf/closed/wall/mineral/plastitanium/nodiagonal,
/area/ship/bridge)
"iJ" = (
/obj/effect/spawner/structure/window/reinforced,
/obj/machinery/door/poddoor/shutters{
	id = "herman_windows";
	dir = 4
	},
/obj/structure/cable{
	icon_state = "0-2"
	},
/turf/open/floor/plating,
/area/ship/bridge)
"jH" = (
/obj/structure/cable{
	icon_state = "4-8"
	},
/obj/structure/cable{
	icon_state = "1-2"
	},
/obj/structure/catwalk/over/plated_catwalk/dark,
/obj/machinery/atmospherics/pipe/manifold/supply/hidden/layer2{
	dir = 1
	},
/obj/machinery/atmospherics/pipe/manifold/scrubbers/hidden/layer4,
/turf/open/floor/plating,
/area/ship/bridge)
"kf" = (
/obj/machinery/door/poddoor{
	id = "herman_bay";
	dir = 4
	},
/obj/effect/turf_decal/industrial/warning/fulltile,
/obj/machinery/power/shieldwallgen/atmos/roundstart{
	id = "herman_fan"
	},
/obj/structure/cable{
	icon_state = "0-10"
	},
/obj/machinery/door/firedoor/border_only{
	dir = 4
	},
/obj/machinery/door/firedoor/border_only{
	dir = 8
	},
/turf/open/floor/engine/hull/reinforced/interior,
/area/ship/bridge)
"la" = (
/obj/structure/cable{
	icon_state = "2-5"
	},
/obj/structure/cable{
	icon_state = "4-8"
	},
/obj/machinery/atmospherics/pipe/simple/supply/hidden/layer2{
	dir = 10
	},
/obj/machinery/atmospherics/pipe/simple/scrubbers/hidden/layer4{
	dir = 9
	},
/obj/effect/turf_decal/trimline/transparent/blue/warning{
	dir = 8
	},
/turf/open/floor/plasteel/mono/dark,
/area/ship/bridge)
"lb" = (
/turf/template_noop,
/area/template_noop)
"lO" = (
/obj/machinery/light/small/directional/west,
/obj/effect/turf_decal/corner/opaque/black/three_quarters,
/obj/structure/closet/crate/engineering,
/obj/item/circuitboard/machine/shuttle/engine/electric/bad,
/obj/item/circuitboard/machine/shuttle/engine/electric/bad,
/obj/item/stock_parts/capacitor,
/obj/item/stock_parts/capacitor,
/obj/item/stock_parts/capacitor,
/obj/item/stock_parts/capacitor,
/obj/item/stock_parts/micro_laser,
/obj/item/stock_parts/micro_laser,
/obj/item/stock_parts/micro_laser,
/obj/item/stock_parts/micro_laser,
/turf/open/floor/plating/airless,
/area/ship/bridge)
"ns" = (
/obj/effect/spawner/structure/window/reinforced,
/obj/machinery/door/poddoor/shutters{
	id = "herman_windows"
	},
/obj/structure/cable{
	icon_state = "2-8"
	},
/obj/structure/cable{
	icon_state = "0-8"
	},
/turf/open/floor/plating,
/area/ship/bridge)
"ow" = (
/obj/structure/cable{
	icon_state = "4-8"
	},
/obj/structure/cable{
	icon_state = "1-4"
	},
/obj/structure/catwalk/over/plated_catwalk/dark,
/obj/machinery/atmospherics/pipe/simple/supply/hidden/layer2{
	dir = 8
	},
/obj/machinery/atmospherics/pipe/simple/scrubbers/hidden/layer4{
	dir = 4
	},
/turf/open/floor/plating,
/area/ship/bridge)
"oL" = (
/obj/machinery/atmospherics/components/unary/portables_connector/visible{
	dir = 4
	},
/obj/machinery/portable_atmospherics/canister{
	name = "waste canister"
	},
/obj/effect/turf_decal/trimline/transparent/blue/warning,
/turf/open/floor/plating/airless,
/area/ship/bridge)
"pg" = (
/obj/structure/chair/comfy/shuttle{
	dir = 8
	},
/obj/machinery/atmospherics/pipe/simple/supply/hidden/layer2{
	dir = 5
	},
/obj/machinery/atmospherics/components/unary/vent_scrubber/on/layer4{
	dir = 4
	},
/obj/machinery/holopad/secure,
/obj/structure/cable{
	icon_state = "4-9"
	},
/obj/structure/cable{
	icon_state = "4-10"
	},
/obj/structure/cable{
	icon_state = "2-4"
	},
/obj/structure/cable{
	icon_state = "1-4"
	},
/obj/structure/cable{
	icon_state = "4-8"
	},
/obj/effect/turf_decal/trimline/transparent/blue/filled,
/obj/machinery/turretid/ship{
	id = "herman_turrets";
	pixel_y = 28;
	req_one_access = list(19,3);
	req_access = null
	},
/turf/open/floor/plasteel/dark,
/area/ship/bridge)
"pv" = (
/obj/machinery/atmospherics/components/unary/vent_scrubber/on/layer4,
/obj/machinery/firealarm/directional/north,
/obj/effect/turf_decal/trimline/transparent/blue/corner{
	dir = 8
	},
/obj/machinery/telecomms/relay/preset/minutemen,
/turf/open/floor/plasteel/mono/dark,
/area/ship/bridge)
"sZ" = (
/obj/machinery/computer/helm{
	dir = 4
	},
/obj/machinery/light/floor{
	icon_state = "floor-on"
	},
/obj/structure/cable{
	icon_state = "4-8"
	},
/obj/effect/turf_decal/corner/transparent/blue/full,
/turf/open/floor/plasteel/dark,
/area/ship/bridge)
"uA" = (
/obj/structure/cable{
	icon_state = "1-2"
	},
/obj/machinery/atmospherics/pipe/layer_manifold,
/obj/machinery/button/door{
	id = "herman_maint";
	pixel_y = 24;
	name = "Maintenance Gate Override"
	},
/obj/effect/turf_decal/corner/opaque/black/half{
	dir = 1
	},
/turf/open/floor/plating/airless,
/area/ship/bridge)
"wS" = (
/obj/structure/closet/secure_closet/wall/directional/east{
	req_one_access = list(19,3);
	name = "cockpit supplies locker"
	},
/obj/item/storage/toolbox/emergency,
/obj/item/gun/ballistic/automatic/pistol/cm23,
/obj/item/ammo_box/magazine/cm23,
/obj/item/ammo_box/magazine/cm23,
/obj/item/clothing/suit/space/eva,
/obj/item/clothing/head/helmet/space/eva,
/obj/item/clothing/mask/gas/clip,
/obj/item/tank/internals/oxygen,
/obj/machinery/atmospherics/components/unary/vent_pump/on/layer2,
/obj/structure/cable{
	icon_state = "1-2"
	},
/obj/effect/turf_decal/corner/transparent/blue/full,
/obj/structure/table/reinforced,
/turf/open/floor/plasteel/dark,
/area/ship/bridge)
"wY" = (
/obj/structure/railing,
/obj/structure/cable{
	icon_state = "0-4"
	},
/obj/machinery/power/port_gen/pacman,
/obj/machinery/firealarm/directional/west,
/obj/structure/sign/poster/clip/bard{
	pixel_y = 32
	},
/obj/effect/turf_decal/trimline/transparent/blue/warning,
/turf/open/floor/plasteel/mono/dark,
/area/ship/bridge)
"yM" = (
/obj/machinery/door/poddoor{
	id = "herman_bay";
	dir = 4
	},
/obj/effect/turf_decal/industrial/warning/fulltile,
/obj/structure/cable{
	icon_state = "4-8"
	},
/obj/docking_port/mobile{
	dir = 8;
	name = "herman dock";
	preferred_direction = 8
	},
/obj/machinery/door/firedoor/border_only{
	dir = 4
	},
/obj/machinery/door/firedoor/border_only{
	dir = 8
	},
/turf/open/floor/engine/hull/reinforced/interior,
/area/ship/bridge)
"yQ" = (
/obj/structure/cable{
	icon_state = "1-2"
	},
/obj/machinery/atmospherics/pipe/simple/supply/hidden/layer2,
/turf/closed/wall/mineral/plastitanium/nodiagonal,
/area/ship/bridge)
"yS" = (
/obj/structure/cable{
	icon_state = "1-2"
	},
/obj/machinery/atmospherics/pipe/simple/scrubbers/hidden/layer4,
/turf/closed/wall/mineral/plastitanium/nodiagonal,
/area/ship/bridge)
"yU" = (
/obj/machinery/atmospherics/components/unary/portables_connector/visible{
	dir = 4
	},
/obj/machinery/portable_atmospherics/canister/air,
/obj/effect/turf_decal/trimline/transparent/blue/warning{
	dir = 1
	},
/turf/open/floor/plating/airless,
/area/ship/bridge)
"zk" = (
/obj/effect/spawner/structure/window/reinforced,
/obj/machinery/door/poddoor/shutters{
	id = "herman_windows"
	},
/obj/structure/cable{
	icon_state = "0-5"
	},
/turf/open/floor/plating,
/area/ship/bridge)
"zU" = (
/obj/effect/spawner/structure/window/reinforced,
/obj/machinery/door/poddoor/shutters{
	id = "herman_windows"
	},
/obj/structure/cable{
	icon_state = "0-4"
	},
/turf/open/floor/plating,
/area/ship/bridge)
"zW" = (
/obj/effect/spawner/structure/window/reinforced,
/obj/machinery/door/poddoor/shutters{
	id = "herman_windows"
	},
/obj/structure/cable{
	icon_state = "0-6"
	},
/turf/open/floor/plating,
/area/ship/bridge)
"Bs" = (
/obj/structure/cable{
	icon_state = "1-2"
	},
/obj/structure/chair/comfy/shuttle,
/obj/machinery/light/directional/north,
/obj/machinery/atmospherics/pipe/simple/scrubbers/hidden/layer4,
/obj/effect/turf_decal/trimline/transparent/blue/warning,
/turf/open/floor/plasteel/mono/dark,
/area/ship/bridge)
"BN" = (
/obj/structure/cable{
	icon_state = "0-4"
	},
/obj/machinery/power/terminal,
/obj/machinery/atmospherics/pipe/simple/supply/hidden/layer2{
	dir = 8
	},
/obj/machinery/atmospherics/pipe/simple/scrubbers/hidden/layer4{
	dir = 4
	},
/obj/structure/cable{
	icon_state = "6-8"
	},
/turf/open/floor/plasteel/stairs{
	icon = 'icons/obj/stairs.dmi';
	dir = 8
	},
/area/ship/bridge)
"CO" = (
/obj/machinery/porta_turret/ship/clip/heavy{
	dir = 5;
	id = "herman_turrets"
	},
/turf/closed/wall/mineral/plastitanium,
/area/ship/bridge)
"DS" = (
/obj/machinery/power/shuttle/engine/electric/premium{
	dir = 8
	},
/obj/structure/window/reinforced/survival_pod/spawner/north,
/obj/structure/window/reinforced/survival_pod/spawner/west,
/obj/effect/turf_decal/industrial/warning/cee{
	dir = 4
	},
/obj/structure/window/reinforced/survival_pod/spawner,
/obj/structure/cable{
	icon_state = "0-8"
	},
/turf/open/floor/plating,
/area/ship/bridge)
"Et" = (
/obj/structure/cable{
	icon_state = "1-8"
	},
/obj/structure/cable{
	icon_state = "4-8"
	},
/obj/machinery/atmospherics/components/unary/vent_pump/on/layer2{
	dir = 1
	},
/obj/machinery/button/door{
	id = "herman_bay";
	name = "Door Control";
	pixel_y = -23;
	pixel_x = -4;
	dir = 1
	},
/obj/machinery/button/shieldwallgen{
	id = "herman_fan";
	pixel_x = 6;
	pixel_y = -21;
	dir = 1
	},
/obj/effect/turf_decal/trimline/transparent/blue/corner{
	dir = 1
	},
/turf/open/floor/plasteel/mono/dark,
/area/ship/bridge)
"EL" = (
/obj/structure/cable{
	icon_state = "4-8"
	},
/obj/structure/catwalk/over/plated_catwalk/dark,
/obj/machinery/atmospherics/pipe/simple/supply/hidden/layer2{
	dir = 4
	},
/obj/machinery/atmospherics/pipe/simple/scrubbers/hidden/layer4{
	dir = 4
	},
/turf/open/floor/plating,
/area/ship/bridge)
"Fs" = (
/obj/structure/table/reinforced,
/obj/machinery/button/door{
	id = "herman_windows";
	dir = 1;
	pixel_x = 7;
	pixel_y = 8;
	name = "Window Control"
	},
/obj/machinery/button/door{
	id = "herman_bay";
	name = "Door Control";
	pixel_y = -2;
	pixel_x = 7;
	dir = 1
	},
/obj/machinery/button/shieldwallgen{
	id = "herman_fan";
	pixel_x = 0;
	pixel_y = 0;
	dir = 1
	},
/obj/item/reagent_containers/food/drinks/mug{
	pixel_x = -9;
	pixel_y = 9
	},
/obj/item/paper/crumpled{
	default_raw_text = "Don't leave the sodding wing maintenance doors open! Not only are you risking punting whatever's in there into deep space, if a xeno crawls in you are bound to fall victim!";
	pixel_x = -6;
	pixel_y = 1
	},
/obj/item/radio/intercom/wideband/directional/east{
	pixel_x = 26;
	pixel_y = 6
	},
/obj/machinery/button/door{
	id = "herman_maint";
	pixel_y = -2;
	name = "Wing Maintenance Gates";
	dir = 1;
	pixel_x = -9
	},
/obj/structure/cable{
	icon_state = "1-2"
	},
/obj/effect/turf_decal/corner/transparent/blue/full,
/turf/open/floor/plasteel/dark,
/area/ship/bridge)
"FE" = (
/obj/effect/spawner/structure/window/reinforced,
/obj/machinery/door/poddoor/shutters{
	id = "herman_windows"
	},
/obj/structure/cable{
	icon_state = "1-8"
	},
/obj/structure/cable{
	icon_state = "0-8"
	},
/turf/open/floor/plating,
/area/ship/bridge)
"FI" = (
/obj/effect/spawner/structure/window/reinforced,
/obj/machinery/door/poddoor/shutters{
	id = "herman_windows";
	dir = 4
	},
/obj/structure/cable{
	icon_state = "2-4"
	},
/obj/structure/cable{
	icon_state = "1-4"
	},
/obj/structure/cable{
	icon_state = "0-4"
	},
/turf/open/floor/plating,
/area/ship/bridge)
"GE" = (
/obj/machinery/light/small/directional/west,
/obj/structure/rack,
/obj/item/storage/toolbox/mechanical{
	pixel_x = -2;
	pixel_y = 10
	},
/turf/open/floor/plating/airless,
/area/ship/bridge)
"GN" = (
/obj/machinery/power/smes/shuttle/precharged{
	dir = 2
	},
/obj/structure/window/reinforced/survival_pod/spawner/north,
/obj/machinery/door/window/survival_pod,
/obj/effect/turf_decal/industrial/warning,
/obj/effect/turf_decal/industrial/warning{
	dir = 1
	},
/obj/structure/cable{
	icon_state = "0-4"
	},
/obj/machinery/door/poddoor/preopen{
	id = "herman_maint"
	},
/turf/open/floor/plating,
/area/ship/bridge)
"Hm" = (
/obj/structure/cable{
	icon_state = "4-8"
	},
/obj/structure/sign/clip,
/turf/closed/wall/mineral/plastitanium/nodiagonal,
/area/ship/bridge)
"IP" = (
/obj/structure/railing{
	dir = 1
	},
/obj/structure/cable{
	icon_state = "0-4"
	},
/obj/machinery/power/smes/engineering{
	output_level = 12000
	},
/obj/effect/turf_decal/trimline/transparent/blue/warning{
	dir = 1
	},
/turf/open/floor/plasteel/mono/dark,
/area/ship/bridge)
"Jn" = (
/obj/machinery/porta_turret/ship/clip/light{
	dir = 10;
	id = "herman_turrets"
	},
/turf/closed/wall/mineral/plastitanium/nodiagonal,
/area/ship/bridge)
"Kg" = (
/obj/machinery/power/terminal{
	dir = 1
	},
/obj/structure/cable{
	icon_state = "0-2"
	},
/obj/machinery/atmospherics/pipe/manifold/scrubbers/hidden{
	dir = 1
	},
/obj/effect/turf_decal/trimline/transparent/blue/warning,
/turf/open/floor/plating/airless,
/area/ship/bridge)
"KB" = (
/obj/machinery/door/airlock/command{
	dir = 4;
	name = "Cockpit";
	req_one_access = list(19,3)
	},
/obj/machinery/door/firedoor/border_only{
	dir = 4
	},
/obj/machinery/door/firedoor/border_only{
	dir = 8
	},
/obj/machinery/atmospherics/pipe/simple/supply/hidden/layer2{
	dir = 8
	},
/obj/machinery/atmospherics/pipe/simple/scrubbers/hidden/layer4{
	dir = 4
	},
/obj/structure/cable{
	icon_state = "4-8"
	},
/turf/open/floor/plasteel/dark,
/area/ship/bridge)
"KS" = (
/obj/machinery/porta_turret/ship/clip/heavy{
	dir = 6;
	id = "herman_turrets"
	},
/turf/closed/wall/mineral/plastitanium,
/area/ship/bridge)
"Le" = (
/obj/machinery/door/poddoor{
	id = "herman_bay";
	dir = 4
	},
/obj/effect/turf_decal/industrial/warning/fulltile,
/obj/machinery/power/shieldwallgen/atmos/roundstart{
	id = "herman_fan";
	dir = 1
	},
/obj/structure/cable{
	icon_state = "0-8"
	},
/obj/machinery/door/firedoor/border_only{
	dir = 4
	},
/obj/machinery/door/firedoor/border_only{
	dir = 8
	},
/turf/open/floor/engine/hull/reinforced/interior,
/area/ship/bridge)
"Ly" = (
/obj/structure/cable{
	icon_state = "4-8"
	},
/obj/structure/cable{
	icon_state = "1-8"
	},
/obj/structure/cable{
	icon_state = "2-8"
	},
/obj/structure/chair/comfy/shuttle{
	dir = 1
	},
/obj/machinery/light/directional/south,
/obj/machinery/atmospherics/pipe/simple/supply/hidden/layer2,
/obj/effect/turf_decal/trimline/transparent/blue/warning{
	dir = 1
	},
/turf/open/floor/plasteel/mono/dark,
/area/ship/bridge)
"Mt" = (
/obj/structure/cable{
	icon_state = "1-2"
	},
/obj/machinery/atmospherics/pipe/layer_manifold,
/obj/machinery/button/door{
	id = "herman_maint";
	pixel_y = -24;
	name = "Maintenance Gate Override";
	dir = 1
	},
/obj/effect/turf_decal/corner/opaque/black/half,
/turf/open/floor/plating/airless,
/area/ship/bridge)
"MC" = (
/obj/machinery/atmospherics/components/binary/valve/on{
	dir = 4
	},
/obj/effect/turf_decal/trimline/transparent/blue/corner{
	dir = 1
	},
/obj/effect/turf_decal/industrial/warning{
	dir = 4
	},
/obj/machinery/door/poddoor/preopen{
	id = "herman_maint";
	dir = 4
	},
/obj/machinery/door/firedoor/border_only{
	dir = 8
	},
/obj/machinery/door/firedoor/border_only{
	dir = 4
	},
/turf/open/floor/plating/airless,
/area/ship/bridge)
"Ri" = (
/obj/effect/spawner/structure/window/reinforced,
/obj/machinery/door/poddoor/shutters{
	id = "herman_windows";
	dir = 4
	},
/obj/structure/cable,
/turf/open/floor/plating,
/area/ship/bridge)
"RW" = (
/obj/structure/cable{
	icon_state = "4-8"
	},
/obj/structure/chair/comfy/shuttle{
	dir = 1
	},
/obj/machinery/power/apc/auto_name/directional/south,
/obj/structure/cable{
	icon_state = "0-4"
	},
/obj/effect/turf_decal/trimline/transparent/blue/warning{
	dir = 1
	},
/obj/effect/turf_decal/floordetail/pryhole,
/turf/open/floor/plasteel/mono/dark,
/area/ship/bridge)
"TQ" = (
/obj/structure/chair/comfy/shuttle,
/obj/machinery/airalarm/directional/north,
/obj/effect/turf_decal/trimline/transparent/blue/warning,
/turf/open/floor/plasteel/mono/dark,
/area/ship/bridge)
"VB" = (
/obj/structure/cable{
	icon_state = "4-8"
	},
/obj/effect/turf_decal/box{
	color = "#75A2BB"
	},
/obj/structure/bed/roller,
/obj/structure/closet/wall/med/directional/south,
/obj/item/storage/firstaid/regular,
/obj/item/reagent_containers/hypospray/medipen,
/obj/item/reagent_containers/hypospray/medipen,
/obj/item/storage/pill_bottle/charcoal,
/obj/structure/cable{
	icon_state = "4-9"
	},
/turf/open/floor/plasteel/mono/white,
/area/ship/bridge)
"WE" = (
/obj/machinery/porta_turret/ship/clip/light{
	dir = 9;
	id = "herman_turrets"
	},
/turf/closed/wall/mineral/plastitanium/nodiagonal,
/area/ship/bridge)
"Yh" = (
/turf/closed/wall/mineral/plastitanium,
/area/ship/bridge)

(1,1,1) = {"
lb
lb
lb
lb
iJ
FI
Ri
lb
lb
lb
lb
"}
(2,1,1) = {"
lb
lb
lb
zU
zW
sZ
zk
zU
lb
lb
lb
"}
(3,1,1) = {"
lb
lb
lb
ns
wS
pg
Fs
FE
lb
lb
lb
"}
(4,1,1) = {"
WE
lb
Yh
iy
iy
KB
iy
iy
Yh
lb
Jn
"}
(5,1,1) = {"
fr
iy
iy
iy
wY
BN
IP
iy
iy
iy
iy
"}
(6,1,1) = {"
fr
oL
lO
iy
dd
ow
VB
iy
GE
yU
iy
"}
(7,1,1) = {"
GN
Kg
Mt
yS
Bs
jH
Ly
yQ
uA
at
cj
"}
(8,1,1) = {"
Hm
eu
dp
iy
TQ
EL
RW
iy
dp
MC
Hm
"}
(9,1,1) = {"
DS
lb
lb
iy
pv
la
Et
iy
lb
lb
cZ
"}
(10,1,1) = {"
lb
lb
lb
CO
kf
yM
Le
KS
lb
lb
lb
"}
